[Joe M.  -  Easy Level]
[Room 1]
WWWWWWWWWWWWWWWWWWWW
WWWWWWWWWWWWWWWWWWWW
WWWWWWWWWWWWWWWWWWWW
WWWWWWWWWWWWWWWWWWWW
WWWWWWWWWWWWWWWWWWWW
WWWWWWWWWWWWWWWWWWWW
W                 WW
WWWWW WWW WWW WWWWWW
WWWWW WWW WWW WWWWWW
W     WWWPWWW     WW
WWWWWWWPPP WWWWWWWWW
W  Â WW     Ç×¶  WWW
W  Ð WWW    Ç×¶  ² W
W Ú¿  WWWW  Ç×¶    W
W ÀÙÒ WW    Ç×¶    W
W >ÆÊµ   WWWWWWWWWWW
W     WWWWWWWWWWWWWW
WWWWWWWWWWWWWWWWWWWW
