[Performance Test]
[Run Run]
WWWWWWWWWWWWWWWWWWWW
WW>               WW
WW                WW
WW                WW
WW                WW
WW                WW
WW                WW
WW                WW
WW                WW
WW                WW
WW                WW
WW                WW
WW                WW
WW                WW
WW                WW
WW                WW
WW                WW
WWWWWWWWWWWWWWWWWWWW
